Случайни Думи LIST
fond|наивен
camaraderie|другарство
prevail|надделее
grant|субсидия
lump|смесвам
custom|персонализиран
propose|предлагам
fallback|отдръпвам се
reference|връзка
colon|двоеточие
snippet|отрязък
sample|образец
overlap|застъпване
adjacent|съседен
precede|предхожда
recruit|възстановявам се
wary|предпазлив
substantial|съществен
accomplish|постигам
alias|псевдоним
involve|призовавам
primary|главен
handy|полезен
expose|излагам
remind|напомням
premise|предпоставка
enforce|позволява
bare|гол
dissuade|разубеждавам
realm|сфера
crave|копнея
acuity|проницателност
bold|смел
trail|несгода
conjunction|съчетание
accommodate|приспособявам
rummor|слух
fluency|плавност
myriad|безброй
convey|изразявам
propose|предлагам
accept|приемам
verbose|многословен
subsite|затихва
fit|готов
precede|предхождащ
handfull|шепа
precaution|препазни мерки
unlike|за разлика от
daunt|обезсърчавам
seduction|съблазняване
resist|приспособявам се
calm|спокоен
genesis|създаване
doubt|съмнение
regard|уважавам
strip|лишавам от собственост
aunt|леля
wish|пожелавам
rule|правило
supply|предлага
suppleness|гъвкавост
rudiment|основа
refine|усъвършенства
behave|държа се
flexible|гъвкав
accommodate|приспособявам
flex|огъвам
laid|поставям
justify|оправда
flee|напускам внезапно
chief|главен
affordability|достъпността
mainland|континент
constitute|съставлява
endure|търпя
warn|съветвам
huracane|ураган
exodus|масивно изселване
wrought|кован
embrace|приемам
peel|обелвам
honor|почит
modest|скромен
parity|равенство
couple|двойка
distinct|отчетлив
expense|разноски
temporary|временен
resist|противопоставям се
penalist|участник в обсъждане
chore|скучна работа
hire|наем
responsibility|отговорност
volunteer|доброволец
cure|лек
bitten|ухапан
seldom|рядко
abdicate|отказвам се
underscore|подчертавам
discretion|свобода на действие
valour|доблест
sage|мъдрец
fascinate|очаровам